
C 255,255,0

F 1,1,2

SO image/wall4.png

NO image/wall1.png

EA image/wall2.png

WE image/wall3.png

F 255,0,255

C 255,255,255

        1111111111111111111111111
        1000000000110000000000001
        1011000001110000000000001
        1001000000000000000000001
111111111011000001110000000000001
100000000011000001110111111111111
11110111111111011100000010001
11110111111111011101010010001
11000000110101011100000010001
10000000000000001100000010001
10000000000000001101010010001
11000001110101011111010110N01
11110111 1110101 101110000001
11111111 1111111 111111111111
