
C 255,255,0

F 1,1,2

SO image/wall4.png

NO image/wall1.png

EA image/wall2.png

WE image/wall3.png



1111111111111111111111
111111N111111111111111
1111110111111111111111
1111110111111111111111
1111110111111111111111
1111110111111111111111
1111110111111111111111
1111110111111111111111
1111111111111111111111
