WE image/wall_texture.png

SO image/wall_texture.png

NO image/wall2.png

EA image/wall2.png

C 60,60,60

F 100,,100,100,,

            111111111111111111111111111111111111111111111111111111111111
            11000001111111111111111111111111111111111111111111111111111111111111111111
            10000000000000000000000000000000000000000000000000000000001111111111111111
            11000001100000000000000000000000000000000000000000000000001111111111111111
1111111111111000000000000000000000000000000000000000000000111111111111111
1101001110000000000000000000000000000000000000000000000000111111111111111 
1100000000000000000000000000000000000000000000000000000000111111111111111 
1000000000000000000001111111111111111111111111110000000001111111111111111 
100000000000000000000001W000000000000000000000000000000001111111111111111 
1000000000000000000001111111111111111111111111110000000001111111111111111 
1000000000000000000000000000000000000000000000000000000001111111111111111 
1000000000000000000000000000000000000000000000000000000001111111111111111 
1000000000000000000000000000000000000000000000000000000001111111111111111 
1000000000000000000000000000000000000000000000000000000001111111111111111 
1000000000000000000000000000000000000000000000000000000001111111111111111 
1000000000000000000000000000000000000000000000000000000001111111111111111 
1000000000000000000000000000000000000000000000000000000001111111111111111 
1000000000000000000000000000000000000000000000000000000001111111111111111 
1111111111111111111111111111111111111111111111111111111111111111111111111 
