NO wall_texture.png

SO hbenouka.png

WE blue_wall.png

EA hicham.png

C 233,255,151

F 193,53,69

11111111111111111111111111111111111111111111111111111111111
11000001111111111111111111111111111111111111111111111111111
10000000000000000000000000000000000000000000000000000000001
11000001100000000000000000000000000000000000000000000000001
11000000000000000000000000000000000000000000000000000000001
11010011100000000000000000000000000000000000000000000000001
11000000000000000000000000000000000000000000000000000000001
10000000000000000000011111110000000000000000000000000000011
100000000000000000000000W0000000000000000000000000000000011
10000000000000000000011111110000000000000000000000000000011
10000000000000000000000000000000000000000000000000000000011
10000000000000000000000000000000000000000000000000000000011
10000000000000000000000000000000000000000000000000000000011
10000000000000000000000000000000000000000000000000000000011
10000000000000000000000000000000000000000000000000000000011
10000000000000000000000000000000000000000000000000000000011
10000000000000000000000000000000000000000000000000000000011
10000000000000000000000000000000000000000000000000000000011
11111111111111111111111111111111111111111111111111111111111

