NO ./path_to_the_north_texture

SO ./path_to_the_south_texture

WE ./path_to_the_west_texture

EA ./path_to_the_east_texture

F 220,100,0

C 225,30,0

11111111111111111111111
11000000000000000000001
10000100000000000000001
11001W10000100000000001
11001100000000000000001
11010010000000000000001
11010010000000000000001
11111111111111111111111
