NO wall_texture.png

SO hbenouka.png

WE blue_wall.png

EA hicham.png

C 233,255,151

F 193,53,69


111111111
100000001
100000001
100010W01
100000001
111110011
111110011
111111111
